XXXXXXXXXXXXXXXXXXXXXXXXXXXXXXXXXXXXXXXX
XXXXXXXXXXXXXXXXXXXXXXXXXXXXXXXXXXXXXXXX
XXXXXE           E           E XXXXXXXXX
XXXXX                          XX    XXX
XXXXX  BB  BB  BB  BB  BB  BB  XX    XXX
XXXXX  BB  BB  BB  BB  BB  BB  XX    XXX
XXXXX  BB  BB  BB  BB  BB  BB  XX    XXX
XXXXX  BB  BB  BBCCBB  BB  BB  XX    XXX
XXXXX  BB  BB  BBCCBB  BB  BB  XX    XXX
XXXXX  BB  BB  BB  BB  BB  BB  XX    XXX
XXXXX  BB  BB          BB  BB  XXXXXXXXX
XXXXX  BB  BB          BB  BB  XXXXXXXXX
XXXXX          BB  BB          XXXXXXXXX
XXXXX          BB  BB          XXXXXXXXX
XXXXXBB  BBBB          BBBB  BBXXXXXXXXX
XXXXXCC  BBBB          BBBB  CCXXXXXXXXX
XXXXX          BB  BB          XXXXXXXXX
XXXXX          BBBBBB          XXXXXXXXX
XXXXX  BB  BB  BBBBBB  BB  BB  XXXXXXXXX
XXXXX  BB  BB  BB  BB  BB  BB  XX    XXX
XXXXX  BB  BB  BB  BB  BB  BB  XX    XXX
XXXXX  BB  BB  BB  BB  BB  BB  XX    XXX
XXXXX  BB  BB          BB  BB  XX    XXX
XXXXX  BB  BB    P     BB  BB  XXXXXXXXX
XXXXX  BB  BB          BB  BB  XXXXXXXXX
XXXXX  BB  BB   BBBB   BB  BB  XXXXXXXXX
XXXXX           BH B           XXXXXXXXX
XXXXX           B  B           XXXXXXXXX
XXXXXXXXXXXXXXXXXXXXXXXXXXXXXXXXXXXXXXXX
XXXXXXXXXXXXXXXXXXXXXXXXXXXXXXXXXXXXXXXX
bbbbbbbbaaa